1111111
1E10C01
1110P01
1111111
