111111111111111
1C10C0000C00001
101C01100000101
100C00001E11111
1000C00C1P10C01
110C00001110111
111111111111111
