111111111
10000C001
10E000C01
111111111
