111111111111111111111111111111111
10000000P000011111000000C00000001
101111100000011000011110111110001
101000100111000000000010000010001
101010100000011111111110111010101
101010111110000010000000C01010001
100000000010111010111111100000001
111111010010000000001000111110001
100000010000111111101000C00000001
101111011111101000101111111011101
10100000000010100010100000000000
101011111111101111101011111110001
101010000000100000000000000010001
101010111110111111101111111010001
101000000010000000101000000000001
101111111011111110101011111111101
1000000E0000000000000000000000001
111111111111111111111111111111111
