111111111111111
1C10C0000C00001
101C01100000101
100C00001C10001
10P0C00C1011C01
110C0000111E111
111111111111111