1111111111111111
10E1000000000001
11110P000C000001
100000000000C001
1111111111111111
