1111111111111111
10E0000000000001
10000P000C000001
100000000000C001
1111111111111111
