1111111111111111
10E00000000C0001
10000P0000000001
100C00000C010101
1111111111111111
