11111111111111111111
1C10C0000C0000000001
101C01100000101111C1
100C000111101C101001
1000C011P10C10010C01
110C000000000000E011
11111111111111111111
