111111111111111111111111111111111111111
1C00000000C0C01011110000C0000011100P001
1010111011101E101111C111110000111000001
1010C1001010111000000111100000111000001
101111000001111C11011111000000111000001
100C000C110000111000100C011000011100001
1011000C11000000000010C0010000111000001
100C0110C11010100110100C010000111000001
10C0010C11000000000010C001100000000C001
101C000C1100001111001C00010000111000001
10C000C01100000C000010C0010000111000001
1001000C11001111100010C0010000111000001
100C0100110000111100100C010000111000001
1C0C000011000011110010C0010000111000001
111111111111111111111111111111111111111
