111111111111111111111111111
1C001000E0C00000100C0001001
1000001000000C00001000C0111
110000100001000101010110101
11C00000000000000000000P001
111111111111111111111111111
