11111111111111111111111111111111
1C01000000100000010P0010000000C1
100100C0001011111110111011111111
1000000000000C000000001C00000001
10010000C00000000000000000000001
11010111000000000011111000000001
11E10000C0100000000C00100C000001
11111111111111111111111111111111
