11111111111111
1E000000000001
11111111111001
10C00000000001
10111111111111
1000C000000001
11111111110111
10000000000001
10111111111C01
1000C000000C01
10000000000001
11111111111011
1000P000000001
11111111111111
