111111111111111111111111111111111
10C0000P0000011111000000000000001
101111100000011000011110111110001
101000100111000000000010C00010001
1010101000C0011111111110111010101
101010111110000010000000001010001
10C000000010111010111111100000001
111111010010000C00001000111110001
100C00010000111111101000000C00001
101111011111101000101111111011101
10100C00000010100010100C000C00001
101011111111101111101011111110C01
101010C0000010000C000000000010001
101010111110111111101111111010001
101000000010000000101000000000001
101111111011111110101011111111101
100C00000C00000000C00000C00C000E1
111111111111111111111111111111111
