111111111111111111111111111111111
1000000000P001111100000E000000001
101111100000011000011110111110C01
1010001001110000000C0010000010001
10101010C000011111111110111010101
101010111110000010000000001010001
10000000001011101011111110000C001
111111010010000000001000111110001
10C000010000111111101000000000001
101111011111101000101111111011101
10C000000000101000101000000000001
101011111111101111101011111110C01
10101000C000100000000000000010001
101010111110111111101111111010001
10100000C010000000101000000000001
101111111011111110101011111111101
10000000C00000000000000000000C001
111111111111111111111111111111111
