1111111111111111
1PC0010000000001
1001E10000000001
1111111111111111
