111111111111111111111111111111111
1000000000000000C0000000000000001
100011110001111000111111111110001
100011110001111000111111111110001
100011110P01111000111100011110001
10001111000111100000000C011110001
100011111111111000111111111110001
10C011111111111000111111111110001
100000000001111000111100000000001
100000000C011110C0111100C11110001
1000C0000001111000111100011110001
100000000001111000111111111110001
100000000001111000111111111110001
10000C000000000000000000000000001
1000000000000C000000000000000C001
10E0000000000000000000C0000000001
111111111111111111111111111111111
