111111111111111
1010C0000C00001
100C01100C00101
100C00001E10001
1000000C1P10C01
110C00001110111
111111111111111