111111111
1000C0001
10E00P001
111111111

