111111111111111111111111111111111111111111111111111111111111111111111111
10E00000C000000000000000000000000000000000000000P00000000000000000000001
111111111111111111111111111111111111111111111111111111111111111111111111
