11111111111111111111111111111111111111111111111111111111111111111
10000000000000000000E0C0P0000000000000000000000000000000000000001
11111111111111111111111111111111111111111111111111111111111111111
