111111111111111
1010C0000C0001
10EC01100000101
100C00001010001
1000P00C1C10C01
110C00001110111
111111111111111