111111111111111
1010C0000C00001
100C01100100101
100C00001010001
1000P00C1E10C01
110C00001110111
111111111111111