111111111111111
1010C0000C00001
100C01100C00101
100C00001110001
1000E00C1P10C01
110C00001110111
111111111111111