111111111111111
101000000000001
100C01100000101
1C00000000C0001
100000C00E00001
1100P0C0000C111
111111111111111