111111111111111111111111111111111111111
1C00000000C0C01011110000C00000111000001
1010111011101E101111C111110000111000001
1010C10010101P1000000111100000111000001
101111000001111C11011111000000111000001
100C000C11000011100010C0011000011100001
1011000C11000000000010C0010000111000001
100C0110C110101001101000010000111000001
100C010C11000000000010C0011000011100001
101C000C1100001111001000010000111000001
100C000C11000000000010C0010000111000001
1001000C11001111100010C0010000111000001
100C010C1100001111001000010000111000001
100C000C11000011110010C0010000111000001
111111111111111111111111111111111111111