1111111111111111111111111111
1C1110001110C01011110000C001
1010111011100E001111C1111101
1010000010100P000000011110C1
101111000000111C110111110001
100C000C11000000000010C00111
1111111111111111111111111111