1111111111111111111111111111
1C00000000C0C01011110000C001
1010111011101E101111C1111101
1010C10010101P100000011110C1
101111000001111C110111110001
100C000C11000000000010C00111
100C000C11000000000010C00111
100C000C11000000000010C00111
100C000C11000000000010C00111
100C000C11000000000010C00111
100C000C11000000000010C00111
100C000C11000000000010C00111
100C000C11000000000010C00111
100C000C11000000000010C00111
1111111111111111111111111111